111111111111111111111111
100000000000000000000001
100000000000000000000001
100000000000000000000001
100000111110000000000001
100000100010000000000001
100000100010000000000001
100000100010000000000001
100000112110000000000001
100000000000000000000001
100000000000000000000001
100000000000000000000001
100000000000000000000001
100000000000000000000001
100000000000000000000001
100000000000000000000001
111111111000000000000001
110000001000000000000001
110010002000000000000001
110000001000000000000001
111111111000000000000001
111111112000000000000001
111111111000000000000011
111111111111111111111111
